WWWWWWWWWWWWWWW
WGGGGGGGGGGGGGW
WGGGGGGGGGGGGGW
WGGGGGGGGGGGGGW
WGGGGGGGGGGGGGW
WGGGGGGGGGGGGGW
WGGGGGGGGGGGGGW
WGGGGGGGGGGGGGW
WGGGGGGGGGGGGGW
WGGGGGGGGGGGGGW
WGGGGGGGGGGGGGW
WGGGGGGGGGGGGGW
WGGGGGGGGGGGGGW
WGGGGGGGGGGGGGW
WWWWWWWWWWWWWWW